#..#......#####....#..#
.######...............#
...#....#.....C...#.##.
##.....................
###..............######
##....................#