##########
#........#
#........#
########C#
#........#
##########