##...###
.#....C#
.....#.#
......#.
########